Font Name	Version	woff2	woff	ttf	eot	svg	Total Size
ABeeZee	13	17048	21292	40048	17743	59699	155830
Abel	11	9588	12556	28940	11004	92122	154210
Abhaya Libre	5	20812	25528	54728	23666	74061	198795
Abril Fatface	11	13120	16896	32272	14923	58862	136073
Aclonica	10	16600	20684	37604	19583	80314	174785
Acme	9	8240	11372	19328	9076	51213	99229
Actor	9	21936	27472	58608	23479	61501	192996
Adamina	13	29048	36084	71336	29350	77006	242824
Advent Pro	10	15876	20052	42012	17987	52089	148016
Aguafina Script	9	15952	19936	41448	17641	113015	207992
Akronim	10	48344	56784	91232	53372	371206	620938
Aladin	9	14556	18156	36624	16225	95350	180911
Alata	2	17568	21724	40288	20208	54560	154348
Alatsi	2	18856	23368	42116	21686	55244	161270
Aldrich	10	16144	20732	45728	15613	60798	159015
Alef	11	20068	24172	41828	20970	69193	176231
Alegreya Sans SC	9	19796	24420	46124	22702	56725	169767
Alegreya Sans	10	20388	24864	44104	23361	61443	174160
Alegreya SC	11	25440	30668	60824	28892	92505	238329
Alegreya	13	25672	30784	54224	29143	91031	230854
Aleo	3	28288	34284	67612	31844	99345	261373
Alex Brush	11	17524	21068	39048	18771	109130	205541
Alfa Slab One	9	17936	22312	43796	20522	51422	155988
Alice	11	25084	30056	61380	29009	108095	253624
Alike Angular	11	25672	32084	70016	25250	61133	214155
Alike	13	28648	34964	66944	27042	73546	231144
Allan	12	21104	26480	42408	24217	75214	189423
Allerta Stencil	10	8332	10564	15740	9205	53234	97075
Allerta	10	7844	9988	15288	8636	52546	94302
Allura	8	19096	22368	40044	20101	109402	211011
Almendra Display	11	10632	14216	32424	11583	88024	156879
Almendra SC	11	11392	14652	29356	12392	82483	150275
Almendra	13	12236	16052	33252	13358	78372	153270
Amarante	8	23352	29596	71908	25828	91889	242573
Amaranth	10	26268	31744	61696	27064	68479	215251
Amatic SC	13	26984	31176	52828	30054	123213	264255
Amethysta	9	25140	31420	62236	23554	68113	210463
Amiko	5	15432	19212	35600	17405	52023	139672
Amiri	14	20452	24536	51488	23210	121178	240864
Amita	6	20916	24912	50300	24058	70945	191131
Anaheim	8	14304	17840	27744	15846	54086	129820
Andada	12	11820	15432	30700	12934	73178	144064
Andika	12	25240	31568	63988	26060	81120	227976
Annie Use Your Telescope	10	14832	17176	26168	15933	98475	172584
Anonymous Pro	13	17540	22396	38832	18881	54347	151996
Antic Didone	9	12540	16764	33428	14972	60986	138690
Antic Slab	8	12012	15968	30724	14185	52656	125545
Antic	11	13688	18104	37116	17022	49402	135332
Anton	11	14220	17808	31188	16176	48411	127803
Arapey	8	8816	11836	21352	9683	58724	110411
Arbutus Slab	8	18892	23284	37684	20819	80830	181509
Arbutus	10	25344	27824	51788	27685	233006	365647
Architects Daughter	10	13144	15660	22352	14289	85377	150822
Archivo Black	9	18584	23180	46888	21175	50337	160164
Archivo Narrow	11	18008	22848	48284	20719	50049	159908
Archivo	6	17328	21424	40468	19770	50752	149742
Aref Ruqaa	9	14564	17988	24916	15781	92229	165478
Arima Madurai	5	19452	23784	39720	21822	78958	183736
Arimo	13	25080	30000	51232	23043	54032	183387
Arizonia	11	19124	22404	40296	19939	110619	212382
Armata	11	17540	22192	44200	19259	67375	170566
Arsenal	4	17608	22124	44176	19999	57417	161324
Artifika	11	35732	43644	82556	36837	113965	312734
Arvo	13	17300	21240	37508	19436	72576	168060
Arya	6	15316	19004	33060	17245	52314	136939
Asap Condensed	5	20700	25172	46288	23641	77360	193161
Asap	11	20432	25012	46644	23410	78873	194371
Asar	8	22560	26616	49812	25381	107906	232275
Asset	10	18732	22300	43728	20244	138726	243730
Assistant	4	16488	20196	35808	19014	55254	146760
Astloch	12	18416	23320	50408	20968	97317	210429
Asul	10	12416	16004	27900	13584	66939	136843
Athiti	5	20076	25008	49232	22895	56427	173638
Atma	6	22480	26876	50448	25942	84668	210414
Atomic Age	13	15964	20172	37852	18188	71261	163437
Aubrey	13	23260	29620	60316	24375	64969	202540
Audiowide	8	14036	17764	33256	16527	69244	150827
Autour One	10	29464	34036	51752	32339	169938	317529
Average Sans	9	8268	11432	20452	9145	46168	95465
Average	9	11712	15524	31464	12996	70883	142579
Averia Gruesa Libre	9	37288	50096	102416	51611	438951	680362
Averia Libre	9	36600	49484	99772	50799	431224	667879
Averia Sans Libre	9	36608	49228	99712	50479	430146	666173
Averia Serif Libre	10	37324	50176	101016	51772	434643	674931
B612 Mono	5	19104	24304	56724	20697	76656	197485
B612	5	21312	26576	59656	21150	74677	203371
Bad Script	8	18636	22472	29272	20005	111411	201796
Bahiana	5	16872	21604	41208	19193	40264	139141
Bahianita	3	22668	28716	53232	26165	41753	172534
Bai Jamjuree	3	10608	13756	25340	12341	55832	117877
Baloo 2	1	26672	32376	70580	30792	79410	239830
Baloo Bhai 2	1	26576	32332	70560	30796	79509	239773
Baloo Bhaina 2	1	26300	31968	70552	30326	79578	238724
Baloo Chettan 2	1	26476	32224	70412	30573	79515	239200
Baloo Da 2	1	26576	32256	70308	30670	79487	239297
Baloo Paaji 2	1	26604	32396	70376	30792	79511	239679
Baloo Tamma 2	1	26568	32280	70824	30602	79511	239785
Baloo Tammudu 2	1	26472	32120	70376	30492	79516	238976
Baloo Thambi 2	1	26592	32192	70252	30525	79513	239074
Balsamiq Sans	1	30596	36144	60992	33998	102550	264280
Balthazar	10	9224	12596	22592	10118	55391	109921
Bangers	12	21160	25132	48440	24524	94722	213978
Barlow Condensed	4	19492	23828	44812	22372	80974	191478
Barlow Semi Condensed	5	20636	25080	46524	23596	84023	199859
Barlow	4	20444	24916	46036	23272	84601	199269
Barriecito	3	52652	61400	117892	58971	141077	431992
Barrio	5	40512	47860	106152	45058	149501	389083
Basic	9	18556	22104	34852	20478	89916	185906
Baskervville	1	22396	26584	51172	25362	82631	208145
Baumans	10	18924	23836	47916	13996	51952	156624
Be Vietnam	2	17860	22076	38836	20390	55420	154582
Bebas Neue	1	13092	16460	33204	15042	43696	121494
Belgrano	11	11168	15068	25236	13164	52958	117594
Bellefair	6	16632	20312	35544	18821	66214	157523
Belleza	9	9460	12920	21876	10478	50355	105089
Bellota Text	2	19448	23852	42976	22590	60320	169186
Bellota	2	20624	25192	46828	23902	65769	182315
BenchNine	8	20244	24300	41708	22566	91684	200502
Bentham	10	17976	22140	32968	20071	68657	161812
Berkshire Swash	8	17336	20164	38224	19174	129663	224561
Beth Ellen	3	40840	45996	75496	45147	203525	411004
Bevan	11	19984	24356	44528	22488	62428	173784
Big Shoulders Display	2	18072	21560	42080	20868	56000	158580
Big Shoulders Text	2	18620	22124	42472	21532	57171	161919
Bigelow Rules	9	19972	23852	41452	22965	103459	211700
Bigshot One	11	14064	18452	42832	16428	75228	167004
Bilbo Swash Caps	13	21320	25040	49504	22710	139220	257794
Bilbo	10	15452	19628	36336	17487	93803	182706
BioRhyme Expanded	6	22988	27660	50412	26673	64168	191901
BioRhyme	5	22792	27392	50996	26514	62940	190634
Biryani	5	14104	17564	31084	15812	48439	127003
Bitter	16	14672	18112	32872	16816	61595	144067
Black And White Picture	8	51688	58684	118368	57595	314123	600458
Black Han Sans	8	9360	12276	24156	10930	21384	78106
Black Ops One	11	13824	18296	37020	15425	37743	122308
Blinker	4	18116	21680	45544	21007	49027	155374
Bonbon	12	31076	37220	70736	30535	135403	304970
Boogaloo	11	10276	13632	23884	11351	56733	115876
Bowlby One SC	11	23724	28672	40316	25469	123392	241573
Bowlby One	12	21576	26096	39468	23481	123840	234461
Brawler	11	35184	43564	87920	35886	72645	275199
Bree Serif	9	10368	13944	24200	11676	55445	115633
Bubblegum Sans	9	14188	18092	33548	16082	81007	162917
Bubbler One	9	10044	13360	28276	11581	44693	107954
Buda	11	23804	29756	48076	28290	68888	198814
Buenard	12	10852	14304	27236	11716	70388	134496
Bungee Hairline	6	16848	20788	44812	19690	53711	155849
Bungee Inline	6	26844	33724	70868	31151	120625	283212
Bungee Outline	6	37368	48604	98860	43123	189213	417168
Bungee Shade	6	43516	57528	131200	49917	194909	477070
Bungee	5	17296	21512	50676	20067	81018	190569
Butcherman	12	30832	36092	50512	33378	210115	360929
Butterfly Kids	9	70540	85152	189988	80991	694526	1121197
Cabin Condensed	13	18424	22664	44124	21554	49010	155776
Cabin Sketch	13	78868	89708	147904	87964	556809	961253
Cabin	14	19252	23556	45632	22537	49829	160806
Caesar Dressing	9	30020	34712	82896	33415	315451	496494
Cagliostro	9	13796	17104	29576	15261	87073	162810
Cairo	7	20672	25868	48332	24902	48224	167998
Caladea	2	20420	24964	47228	23294	70460	186366
Calistoga	2	24308	29108	54876	27642	83819	219753
Calligraffitti	12	29920	35092	56340	32190	166951	320493
Cambay	7	20260	25236	63088	23083	54332	185999
Cambo	9	9612	13108	23796	10570	58979	116065
Candal	9	11776	14964	22976	13142	74985	137843
Cantarell	9	10748	14168	21880	11665	59840	118301
Cantata One	9	18548	23636	47312	20398	68083	177977
Cantora One	10	25344	30780	74420	28772	79505	238821
Capriola	7	20836	25652	50496	22876	100384	220244
Cardo	11	14912	18576	27536	16053	96189	173266
Carme	11	18668	23604	73928	24286	43636	184122
Carrois Gothic SC	10	14564	18572	34940	15255	48642	131973
Carrois Gothic	11	15604	19744	36096	16194	53644	141282
Carter One	11	28048	33744	57788	33128	162411	315119
Catamaran	7	8516	11096	17844	9561	53300	100317
Caudex	9	15808	19824	39944	17312	103937	196825
Caveat Brush	5	67548	86256	160360	75202	172522	561888
Caveat	7	62008	72412	142004	71026	169431	516881
Cedarville Cursive	11	23148	26340	41080	25035	168190	283793
Ceviche One	11	14316	18260	30832	16398	70820	150626
Chakra Petch	3	8880	12084	22264	10369	36956	90553
Changa One	12	7924	10948	18264	8731	49423	95290
Changa	10	15428	18980	34584	17579	52707	139278
Chango	9	12096	15488	29928	13115	80484	151111
Charm	5	18928	22640	42324	21506	113255	218653
Charmonman	3	18924	22536	34348	21211	105744	202763
Chathura	6	6992	8960	14088	7673	31972	69685
Chau Philomene One	10	10572	14196	27220	11429	58753	122170
Chela One	9	12556	15928	29132	13731	72429	143776
Chelsea Market	8	61556	71248	163492	69576	584607	950479
Cherry Cream Soda	11	24236	28456	46712	27011	147332	273747
Cherry Swash	9	8304	11412	21580	9037	55771	106104
Chewy	11	19920	22880	37904	22116	128507	231327
Chicle	9	14820	18552	35348	16672	88510	173902
Chilanka	6	17544	21416	39472	18959	113008	210399
Chivo	11	18508	23232	45596	21731	52632	161699
Chonburi	5	18580	23352	48612	20773	69993	181310
Cinzel Decorative	8	14488	17340	35136	15436	68506	150906
Cinzel	9	13464	16248	32724	14244	62372	139052
Clicker Script	8	23004	26332	45660	25301	134976	255273
Coda Caption	13	21660	26720	46076	25318	58895	178669
Coda	15	20900	25332	47836	23166	77552	194786
Codystar	8	39860	48432	100004	44888	509031	742215
Coiny	6	15488	18660	33116	16715	82836	166815
Combo	9	21132	25316	68660	23557	80583	219248
Comfortaa	29	18072	21888	44412	20518	76645	181535
Comic Neue	2	19068	23512	42040	21795	84635	191050
Coming Soon	12	21400	24952	44148	23717	151451	265668
Concert One	10	24308	30248	63536	26783	118747	263622
Condiment	8	16604	21028	37788	19079	90843	185342
Contrail One	10	10588	14212	26108	11516	78593	141017
Convergence	9	9464	12756	22644	10704	51293	106861
Cookie	11	14456	17880	34224	15948	94334	176842
Copse	10	26800	32872	63064	29968	106234	258938
Corben	14	15540	19252	27460	16825	98133	177210
Cormorant Garamond	7	32092	39072	91188	36220	95341	293913
Cormorant Infant	8	30232	37128	82396	34278	94513	278547
Cormorant SC	8	25512	31164	69864	29059	96452	252051
Cormorant Unicase	8	25792	31424	70584	29312	96278	253390
Cormorant Upright	6	31160	37136	80276	35190	94644	278406
Cormorant	8	29128	34744	72444	32796	95268	264380
Courgette	7	24984	30424	58964	27317	124107	265796
Courier Prime	2	18764	23128	43944	20977	99398	206211
Cousine	14	18456	22756	37548	18709	49480	146949
Coustard	11	26516	32424	66308	29263	122436	276947
Covered By Your Grace	9	16312	19440	32644	17290	126811	212497
Crafty Girls	10	37168	43760	70592	40514	210921	402955
Creepster	9	28120	32740	57492	31937	227851	378140
Crete Round	8	11492	15252	30108	12696	76834	146382
Crimson Pro	13	15548	18980	39256	18049	72527	164360
Crimson Text	10	14888	18268	30192	16190	103073	182611
Croissant One	8	9140	12424	24188	10035	59373	115160
Crushed	11	12108	14820	29392	13642	81877	151839
Cuprum	11	15320	19200	40532	17590	47315	139957
Cute Font	8	9424	12332	23104	11098	29950	85908
Cutive Mono	8	20776	25384	46508	23125	99377	215170
Cutive	12	22992	28600	59112	25622	101303	237629
Damion	9	18960	21956	31352	20664	149984	242916
Dancing Script	15	23496	28436	51176	28448	107091	238647
Darker Grotesque	2	18116	21856	39204	20677	56062	155915
David Libre	5	22372	26448	42516	24680	92484	208500
Dawning of a New Day	11	17824	21672	38760	19578	105610	203444
Days One	9	13872	18224	36568	16705	132054	217423
Dekko	7	15656	18504	27840	17207	97111	176318
Delius Swash Caps	12	18684	23540	45144	22142	89318	198828
Delius Unicase	14	10956	13876	25920	11901	80799	143452
Delius	10	16816	21656	43808	20183	79649	182112
Della Respira	8	16348	20084	37448	18545	97365	189790
Denk One	8	18488	21840	39924	20275	118504	219031
Devonshire	9	17704	21228	39644	19636	105069	203281
Dhurjati	8	11992	14524	25804	13304	32498	98122
Didact Gothic	13	16812	20780	40324	19153	54285	151354
Diplomata SC	9	13684	17588	35172	14986	89188	170618
Diplomata	12	14168	18280	36024	15483	92252	176207
DM Mono	2	14440	17868	31516	16438	49162	129424
DM Sans	4	18076	22292	41248	21390	52357	155363
DM Serif Display	4	24980	29916	56332	29815	73043	214086
DM Serif Text	4	25068	29560	57972	29442	74148	216190
Do Hyeon	11	9872	12892	23692	11254	29095	86805
Dokdo	8	15276	18980	32176	17480	49298	133210
Domine	7	24016	29392	67744	27569	69348	218069
Donegal One	8	20816	24452	36436	22508	105721	209933
Doppio One	8	17436	21508	35544	19211	79614	173313
Dorsa	11	7152	9940	19012	7900	41475	85479
Dosis	18	21484	25712	49992	25151	78233	200572
Dr Sugiyama	10	15312	19020	34808	17023	88971	175134
Duru Sans	14	17216	21652	41872	18866	59968	159574
Dynalight	9	17724	21160	36836	19524	122971	218215
Eagle Lake	8	28220	33192	55100	32832	148497	297841
East Sea Dokdo	8	32056	37072	64928	35484	173811	343351
Eater	9	41716	48628	71204	45072	325863	532483
EB Garamond	14	29060	33616	63716	33124	127950	287466
Economica	7	10284	13600	23484	11263	58697	117328
Eczar	8	19056	23568	46420	21455	57245	167744
El Messiri	6	19080	23512	49580	22159	59339	173670
Electrolize	8	16632	21440	51172	16117	73630	178991
Elsie Swash Caps	9	11408	15032	29980	12464	74556	143440
Elsie	10	10524	14084	28792	11484	70707	135591
Emblema One	9	13320	17444	30268	13738	83440	158210
Emilys Candy	8	83588	98596	221748	95782	794326	1294040
Encode Sans Condensed	4	19812	24588	45936	23185	56590	170111
Encode Sans Expanded	5	19884	24672	45664	23112	57333	170665
Encode Sans Semi Condensed	5	20064	24876	46744	23480	56557	171721
Encode Sans Semi Expanded	6	20172	24932	46196	23448	57013	171761
Encode Sans	7	12548	16008	28560	14474	55241	126831
Engagement	10	25788	29428	54264	28545	196829	334854
Englebert	8	17544	21308	35972	20160	88332	183316
Enriqueta	9	20104	24444	42844	22983	68880	179255
Epilogue	1	11980	15372	27560	13342	64684	132938
Erica One	11	8288	11400	20532	9056	47717	96993
Esteban	9	14668	18912	34132	17098	84788	169598
Euphoria Script	9	15848	18908	34392	16705	97689	183542
Ewert	8	13708	18092	65956	14694	176116	288566
Exo 2	9	14936	18336	36904	17257	58719	146152
Exo	11	11072	13944	24704	12745	54612	117077
Expletus Sans	14	19104	24320	52372	19246	62033	177075
Fahkwang	4	10424	13468	22244	11866	56954	114956
Fanwood Text	10	29224	35540	57920	32419	129829	284932
Farro	2	18368	22488	41544	20849	58355	161604
Farsan	6	14768	18768	36312	17023	95490	182361
Fascinate Inline	10	18276	21820	41884	20078	133095	235153
Fascinate	9	15172	18316	35336	16853	110827	196504
Faster One	12	12052	16448	38056	13470	88024	168050
Fauna One	7	9236	12404	22064	10094	53039	106837
Faustina	7	22828	27872	55656	26087	61225	193668
Federant	13	18436	22544	42692	21087	93704	198463
Federo	12	26552	33072	72200	26559	61863	220246
Felipa	7	12196	15852	28648	13120	74744	144560
Fenix	8	13216	17352	38880	15229	60403	145080
Finger Paint	10	53496	61028	98816	56350	338427	608117
Fira Code	9	21316	27420	51904	25007	55211	180858
Fira Mono	8	16836	21024	36760	19278	50947	144845
Fira Sans Condensed	4	21404	26036	54652	25193	52751	180036
Fira Sans Extra Condensed	4	21280	25916	54988	25258	52951	180393
Fira Sans	10	21244	25888	54984	25059	53644	180819
Fjalla One	7	16540	19976	30672	18189	73242	158619
Fjord One	9	16168	19444	36200	17178	101157	190147
Flamenco	11	12328	16316	31896	14101	69792	144433
Flavors	10	67020	82788	175040	75461	588244	988553
Fondamento	10	24572	29220	55916	29011	102154	240873
Fontdiner Swanky	11	16988	22136	42404	21917	191551	294996
Forum	10	23744	30208	70216	25301	72859	222328
Francois One	14	16916	20836	35188	19292	51139	143371
Frank Ruhl Libre	5	19900	24212	44600	22724	71902	183338
Freckle Face	9	39652	45768	83348	45287	285638	499693
Fredericka the Great	9	203128	248580	460792	226939	1760948	2900387
Fredoka One	7	15524	19520	39724	17649	81852	174269
Fresca	9	8856	12180	20180	9780	52766	103762
Frijole	9	92312	109896	220036	103482	831410	1357136
Fruktur	13	23320	27996	45664	25860	107196	230036
Fugaz One	9	10876	14388	23728	12373	56694	118059
Gabriela	9	17672	21400	40008	19771	82343	181194
Gaegu	8	17268	21456	39176	20190	58533	156623
Gafata	9	11708	15300	33852	13539	52530	126929
Galada	5	20256	24768	55108	23033	78213	201378
Galdeano	10	8240	11476	19776	9072	48907	97471
Galindo	8	20088	24200	40972	23084	106023	214367
Gamja Flower	8	18836	24440	50156	22648	61872	177952
Gayathri	2	9276	11964	17772	10217	70847	120076
Gelasio	1	23736	28824	50024	26529	106915	236028
Gentium Basic	11	22332	29072	60352	26370	98541	236667
Gentium Book Basic	10	23088	29660	61172	26834	98812	239566
Geo	12	8100	11132	23008	9345	25412	76997
Geostar Fill	11	9860	15708	34368	15080	176641	251657
Geostar	11	10820	16772	36656	16008	183101	263357
Germania One	8	9080	12088	22908	9960	60348	114384
Gidugu	7	14712	18516	34524	16536	43896	128184
Gilda Display	8	11124	14728	28312	12314	67023	133501
Girassol	2	10120	12956	21828	11199	62054	118157
Give You Glory	10	18696	21108	32156	19990	120694	212644
Glass Antiqua	8	12908	16620	32320	14901	68395	145144
Glegoo	9	17604	22024	45284	19659	60296	164867
Gloria Hallelujah	11	18692	21680	33208	19504	118954	212038
Goblin One	10	12764	15988	29876	13913	86912	159453
Gochi Hand	10	19924	22804	33664	21846	143628	241866
Gorditas	8	39364	49084	92964	42593	112191	336196
Gothic A1	8	14848	20688	45376	18209	48951	148072
Gotu	1	33328	39968	83336	39026	84441	280099
Goudy Bookletter 1911	10	26552	31708	47508	29611	113597	248976
Graduate	7	6088	8900	18104	6972	36818	76882
Grand Hotel	8	19180	22428	45988	21332	148607	257535
Gravitas One	10	13508	16744	33876	14757	99908	178793
Great Vibes	7	19524	23060	42448	20497	116670	222199
Grenze Gotisch	1	13592	17184	31020	15330	87153	164279
Grenze	2	19132	23408	41976	21795	61752	168063
Griffy	9	69896	82280	190492	79260	692579	1114507
Gruppo	10	24648	29092	72260	27914	102295	256209
Gudea	9	7856	11024	16820	8616	43053	87369
Gugi	8	9392	12404	23004	10847	33313	88960
Gupter	2	20724	24668	46428	23380	71692	186892
Gurajada	8	15148	18732	31156	16697	51818	133551
Habibi	9	11468	14520	20736	12412	70081	129217
Halant	7	18668	23412	42492	20998	62314	167884
Hammersmith One	10	19612	24492	50172	21503	70905	186684
Hanalei Fill	9	24344	28680	69444	29317	241553	393338
Hanalei	11	49328	73184	146524	55583	575465	900084
Handlee	8	16152	20604	35912	19100	73391	165159
Happy Monkey	9	24872	31596	63836	25997	76965	223266
Harmattan	8	10368	13120	20192	11355	64586	119621
Headland One	8	25148	31668	70836	27665	95114	250431
Heebo	9	10000	13012	18824	11256	58347	111439
Henny Penny	8	44812	51664	79496	49694	214920	440586
Hepta Slab	8	18208	22272	41984	21435	61958	165857
Herr Von Muellerhoff	10	17860	22476	41096	20004	101244	202680
Hi Melody	8	19064	24808	53048	23114	62700	182734
Hind Guntur	5	14372	18492	35808	16565	47063	132300
Hind Madurai	5	14368	18508	35812	16603	47100	132391
Hind Siliguri	6	14544	18552	35796	16649	47085	132626
Hind	10	16264	20660	37904	18568	47275	140671
Hind Vadodara	6	14428	18524	35816	16623	47103	132494
Holtwood One SC	10	12500	15576	28672	13987	68055	138790
Homemade Apple	10	48316	57980	102508	53306	392901	655011
Homenaje	10	13172	16664	31536	14879	44553	120804
Ibarra Real Nova	2	28740	33320	65988	32538	78433	239019
IBM Plex Mono	5	13652	17868	37048	15562	53494	137624
IBM Plex Sans Condensed	7	18120	23024	50524	21451	53994	167113
IBM Plex Sans	7	17784	22620	51204	21009	57793	170410
IBM Plex Serif	8	18736	23456	53552	22113	66097	183954
Iceberg	8	12304	15568	32608	13773	32592	106845
Iceland	9	11600	14916	33092	13001	38442	111051
IM Fell Double Pica SC	10	56692	66612	123088	66569	569480	882441
IM Fell Double Pica	10	60148	69820	127312	70141	551814	879235
IM Fell DW Pica SC	10	57908	67812	125140	67432	575672	893964
IM Fell DW Pica	10	62616	72724	132364	72403	577656	917763
IM Fell English SC	10	56956	66644	113428	65963	532589	835580
IM Fell English	10	59880	69684	116624	69229	509692	825109
IM Fell French Canon SC	10	34452	40548	71624	41694	334618	522936
IM Fell French Canon	10	36984	43124	74872	44432	333379	532791
IM Fell Great Primer SC	10	59028	70068	128732	69465	597211	924504
IM Fell Great Primer	10	62408	72816	131716	72689	573381	913010
Imprima	9	8056	11204	19580	8931	45951	93722
Inconsolata	20	16164	19688	32580	17812	60100	146344
Inder	9	9880	12852	19076	10811	55544	108163
Indie Flower	11	19572	22208	34792	21113	133421	231106
Inika	9	11032	14480	25680	12052	72039	135283
Inknut Antiqua	6	14092	18268	36600	15979	60788	145727
Inria Sans	2	19740	24364	48952	22876	50469	166401
Inria Serif	2	22988	27872	58668	26506	69325	205359
Inter	2	16904	21392	45656	20345	59409	163706
Irish Grover	10	23624	27344	49240	27076	179706	306990
Istok Web	14	24064	30576	66204	27710	76725	225279
Italiana	9	10052	13492	26276	11470	51002	112292
Italianno	9	16236	19480	38320	17102	103923	195061
Itim	4	45768	54152	125600	52227	118240	395987
Jacques Francois Shadow	9	41188	49712	78128	40036	166932	375996
Jacques Francois	8	28776	34164	57856	26664	111719	259179
Jaldi	6	21900	26572	47528	24680	86915	207595
Jim Nightshade	8	51068	60684	116992	57456	423573	709773
Jockey One	9	9300	12396	22656	10586	38764	93702
Jolly Lodger	8	17852	21212	35332	19917	129274	223587
Jomhuria	8	11936	14820	22332	12453	59950	121491
Jomolhari	2	26500	33392	71288	27944	87205	246329
Josefin Sans	16	10952	13968	24700	12562	54084	116266
Josefin Slab	10	37264	47444	108260	41256	67174	301398
Jost	3	9048	12020	24000	10059	54435	109562
Joti One	9	8736	12060	21272	9653	50968	102689
Jua	8	16656	20508	34720	18866	59022	149772
Judson	12	19800	24816	49316	23084	61148	178164
Julee	10	11240	14484	24628	12418	70226	132996
Julius Sans One	8	15960	20552	38980	18548	43408	137448
Junge	8	27144	34528	66964	26980	88142	243758
Jura	15	11824	14936	27072	13289	73705	140826
Just Another Hand	11	35692	42820	78460	39866	159226	356064
Just Me Again Down Here	12	17584	21712	37696	18955	73542	169489
K2D	4	12712	16020	30152	14532	71245	144661
Kadwa	4	19184	23708	44020	21689	65388	173989
Kalam	10	22344	27304	47592	25171	75327	197738
Kameron	10	24500	32208	65664	30166	148337	300875
Kanit	6	19040	23332	48908	21947	47593	160820
Karla	13	6332	8800	14400	7061	33749	70342
Karma	10	17528	21432	39388	18901	59605	156854
Katibeh	7	11556	14636	24884	12860	74718	138654
Kaushan Script	8	34792	41236	103320	39787	114398	333533
Kavivanar	6	11332	14664	23964	12362	76968	139290
Kavoon	9	23852	28588	47112	26409	109305	235266
Keania One	8	10292	14008	29620	11547	67390	132857
Kelly Slab	11	10004	14108	27632	12672	101003	165419
Kenia	12	19964	25896	60368	22045	91733	220006
Khand	8	13944	18060	32592	15783	42778	123157
Khula	5	10528	12984	21776	11809	22712	79809
Kirang Haerang	8	34988	44520	93136	40538	148959	362141
Kite One	8	11320	14996	28240	12652	73659	140867
Knewave	8	17344	19652	28716	18059	108533	192304
Kodchasan	4	14016	17540	32260	15865	85050	164731
KoHo	4	12256	15628	28932	14285	58866	129967
Kosugi Maru	6	6016	7884	11608	6557	26007	58072
Kosugi	6	4936	6668	9748	5451	18709	45512
Kotta One	8	10488	14128	28272	11485	74617	138990
Kranky	11	76028	90936	190508	86016	700996	1144484
Kreon	23	15496	19756	35632	18369	60474	149727
Kristi	12	25648	31028	45624	28381	94009	224690
Krona One	8	10432	13468	20868	10818	73348	128934
Krub	3	10840	13744	21768	12161	57766	116279
Kulim Park	2	16204	19916	38156	19088	54124	147488
Kumar One Outline	6	8608	11788	18892	9545	46525	95358
Kumar One	5	6728	9500	14756	7473	35318	73775
Kurale	6	22620	27212	56468	25420	80502	212222
La Belle Aurore	11	18044	20612	32500	19504	127693	218353
Lacquer	3	75136	84596	196784	87795	538064	982375
Laila	7	18712	23244	43424	21173	67653	174206
Lakki Reddy	7	28892	33364	59416	31902	137424	290998
Lalezar	6	15440	19044	32712	17417	56545	141158
Lancelot	10	22656	26540	40164	20662	79091	189113
Lateef	15	24792	31920	63884	27355	94500	242451
Lato	16	23484	28660	60524	26668	80331	219667
League Script	12	25260	30100	49096	28830	163799	297085
Leckerli One	10	16744	20524	40684	18591	96785	193328
Ledger	9	10972	14476	25284	12612	46948	110292
Lekton	11	9228	12676	20688	10080	39065	91737
Lemon	9	10960	14356	27780	12023	76681	141800
Lemonada	11	20252	23972	41196	23008	99494	207922
Lexend Deca	1	12536	15632	26244	14161	56108	124681
Lexend Exa	1	12696	15852	26376	14408	56834	126166
Lexend Giga	1	12648	15936	26408	14494	56899	126385
Lexend Mega	1	12808	15952	26432	14494	57024	126710
Lexend Peta	1	12724	15968	26468	14513	57228	126901
Lexend Tera	1	12708	15960	26496	14481	57411	127056
Lexend Zetta	1	12616	15864	26560	14399	57708	127147
Libre Barcode 128 Text	10	11008	13836	38648	13177	37141	113810
Libre Barcode 128	10	3744	4768	20472	4675	13884	47543
Libre Barcode 39 Extended Text	9	10284	12812	33236	12318	45450	114100
Libre Barcode 39 Extended	9	3176	4076	15432	3928	22146	48758
Libre Barcode 39 Text	10	6352	7888	22140	7518	26906	70804
Libre Barcode 39	10	3008	3792	13992	3634	12025	36451
Libre Baskerville	7	27108	33008	78732	31161	82684	252693
Libre Caslon Display	2	24288	29316	59352	28144	70433	211533
Libre Caslon Text	2	23940	29016	57344	27691	71571	209562
Libre Franklin	4	20320	24668	44244	23212	86553	198997
Life Savers	11	35844	41656	99672	40397	133009	350578
Lilita One	7	10692	13560	24372	11169	64390	124183
Lily Script One	8	13796	17048	31084	14722	82402	159052
Limelight	11	23024	28428	63588	25425	83203	223668
Linden Hill	10	23456	28744	57364	26705	100330	236599
Literata	16	14400	17996	32960	16634	71736	153726
Liu Jian Mao Cao	5	14068	16544	23352	15342	61839	131145
Livvic	3	18524	22396	43500	21363	53939	159722
Lobster Two	12	47248	65852	204780	55465	84432	457777
Lobster	22	33428	41508	101388	37951	76423	290698
Londrina Outline	11	63332	73584	155372	70522	210704	573514
Londrina Shadow	10	57868	67620	152520	64588	206406	549002
Londrina Sketch	9	100560	117336	282552	113136	499079	1112663
Londrina Solid	9	30812	36640	79452	35193	117780	299877
Long Cang	5	12348	14796	21212	13622	54511	116489
Lora	16	18472	22384	40240	21970	79868	182934
Love Ya Like A Sister	11	68540	91468	165292	76560	491887	893747
Loved by the King	10	11108	13840	19036	12087	65201	121272
Lovers Quarrel	8	22284	26040	49824	23581	135854	257583
Luckiest Guy	10	17372	21732	40720	20908	78614	179346
Lusitana	7	11828	15192	27400	12577	71739	138736
Lustria	8	11720	15028	28792	12721	82334	150595
M PLUS 1p	19	12684	17252	34704	15739	43995	124374
M PLUS Rounded 1c	10	15532	20768	45424	18765	74556	175045
Ma Shan Zheng	5	13084	15156	23128	14423	53175	118966
Macondo Swash Caps	8	11956	15000	27060	13107	84215	151338
Macondo	9	11596	14708	29140	12646	78939	147029
Mada	8	11424	14248	24440	13022	53280	116414
Magra	9	8960	12200	20060	9760	51487	102467
Maiden Orange	11	15608	18932	33100	17811	85023	170474
Maitree	5	21024	26176	53348	23803	70833	195184
Major Mono Display	5	16720	21108	41476	19063	53790	152157
Mako	12	23812	34572	72728	34507	290203	455822
Mali	3	17032	20472	33736	19100	100612	190952
Mallanna	8	13060	15516	25140	14426	38215	106357
Mandali	9	12732	15216	24552	14076	38049	104625
Manjari	3	10600	13428	19308	11535	83421	138292
Manrope	3	12592	15896	31744	14273	53943	128448
Mansalva	2	49952	56908	94528	55076	132790	389254
Manuale	7	23708	28972	60624	27213	56079	196596
Marcellus SC	7	14580	17468	32392	16225	98411	179076
Marcellus	7	14548	17488	30980	16071	100639	179726
Marck Script	10	13412	17244	31612	15401	70547	148216
Margarine	9	52728	62368	113896	59456	418162	706610
Markazi Text	12	13544	17160	35440	15300	69657	151101
Marko One	10	15696	19408	31360	16554	93482	176500
Marmelad	10	30356	36992	74508	29775	102420	274051
Martel Sans	6	14920	18384	32204	16627	54490	136625
Martel	4	18824	22976	39196	20856	64301	166153
Marvel	10	11252	16260	33216	16038	167103	243869
Mate SC	9	9300	12396	23972	10264	60908	116840
Mate	9	9248	12288	22388	10168	62730	116822
Maven Pro	21	9508	12268	19804	10724	47779	100083
McLaren	8	18236	21960	37840	21083	86977	186096
Meddon	13	49992	59784	83668	50648	223793	467885
MedievalSharp	12	38772	48304	96980	40092	116190	340338
Medula One	10	10900	14432	29836	12052	68392	135612
Meera Inimai	5	11904	15568	24500	12889	65259	130120
Megrim	11	11532	15832	29672	13278	39487	109801
Meie Script	8	40680	57184	122800	46317	161130	428111
Merienda One	10	11168	14212	24704	12182	78977	141243
Merienda	8	12856	16576	31632	14348	78785	154197
Merriweather Sans	11	17132	21272	34004	19456	68558	160422
Merriweather	21	19300	23600	40308	21684	65455	170347
Metal Mania	10	76976	99936	217640	88291	648045	1130888
Metamorphous	11	23108	28632	64184	25400	83449	224773
Metrophobic	14	18580	23052	41564	21317	62069	166582
Michroma	10	17132	20688	35364	19248	74342	166774
Milonga	8	32988	38832	98704	37597	126941	335062
Miltonian Tattoo	16	45756	53588	92932	48902	132351	373529
Miltonian	14	53848	63636	108948	56874	218654	501960
Mina	4	11416	14644	26376	12418	65688	130542
Miniver	9	22968	26184	41336	25135	156930	272553
Miriam Libre	6	12948	16644	33972	14936	83977	162477
Mirza	7	12816	15768	26652	14357	76242	145835
Miss Fajardose	10	22124	27092	52408	24260	141582	267466
Mitr	5	22232	27684	61324	25662	81836	218738
Modak	5	33560	41156	81272	38668	85054	279710
Modern Antiqua	10	12632	16140	34748	13740	94149	171409
Mogra	7	25324	30496	65608	28542	98360	248330
Molengo	10	14032	17756	32320	15577	51581	131266
Molle	9	25088	29896	45040	27583	119974	247581
Monda	9	14064	17740	28564	15777	47300	123445
Monofett	10	7800	9588	22276	8441	97300	145405
Monoton	9	16512	21276	39708	17931	141475	236902
Monsieur La Doulaise	9	18976	23804	48632	20818	131750	243980
Montaga	8	11976	15280	28660	13351	63527	132794
Montez	11	22212	25604	46128	24669	140080	258693
Montserrat Alternates	11	19756	24092	48440	23090	57186	172564
Montserrat Subrayada	9	7180	9636	19844	8017	41235	85912
Montserrat	14	19172	23480	46392	22423	53727	165194
Mountains of Christmas	13	56320	66324	113660	65074	361006	662384
Mouse Memoirs	8	18320	22024	37768	21146	92843	192101
Mr Bedfort	9	15960	19588	32476	17613	94626	180263
Mr Dafoe	8	17388	21700	42180	19133	110422	210823
Mr De Haviland	9	17072	21372	39164	18863	102357	198828
Mrs Saint Delafield	7	18764	23380	43128	21006	107920	214198
Mrs Sheppards	9	16040	20304	36856	18200	90921	182321
Mukta Mahee	6	20660	25304	52472	23649	58830	180915
Mukta Malar	6	20200	25004	51452	23355	58230	178241
Mukta	7	20264	24820	51404	23157	58982	178627
Mukta Vaani	7	20276	24932	52408	23363	59040	180019
Mulish	1	16756	20648	39348	19240	46065	142057
MuseoModerno	2	10740	13604	23936	12311	55559	116150
Mystery Quest	8	21836	25228	38120	24075	138917	248176
Nanum Brush Script	17	19960	25052	41980	22561	79899	189452
Nanum Gothic Coding	14	14296	17480	27712	14889	44264	118641
Nanum Gothic	17	17108	21148	36396	18015	70602	163269
Nanum Myeongjo	15	19480	24464	42816	22431	57339	166530
Nanum Pen Script	15	18264	22568	37008	20139	66982	164961
Neucha	11	25376	31624	65788	25715	62338	210841
Neuton	12	19548	24020	41184	21767	69469	175988
New Rocker	9	29272	36352	84564	33389	115258	298835
News Cycle	16	13224	16424	29104	14749	54951	128452
Niconne	9	15172	19028	30512	16499	96552	177763
Niramit	5	11732	14904	27228	13432	58754	126050
Nixie One	11	15792	21448	49108	19617	80074	186039
Nobile	11	22188	28020	43004	25223	72219	190654
Norican	8	18028	21972	33924	19952	110609	204485
Nosifer	9	14976	18256	33044	16056	147407	229739
Notable	5	13848	16760	31512	15634	48812	126566
Nothing You Could Do	9	16084	18344	26768	16901	103856	181953
Noticia Text	9	22260	27408	48284	21913	76169	196034
Noto Sans HK	5	17616	18876	0	28926	1644	67062
Noto Sans JP	25	16816	17928	0	27638	1644	64026
Noto Sans KR	12	13176	14316	0	23454	1644	52590
Noto Sans SC	11	16812	17904	0	27398	1644	63758
Noto Sans TC	10	16844	17956	0	27426	1644	63870
Noto Sans	9	16056	19916	30376	17255	54935	138538
Noto Serif JP	7	23780	25536	0	38656	1645	89617
Noto Serif KR	6	24444	26220	0	40036	1645	92345
Noto Serif SC	7	23560	25228	0	37852	1645	88285
Noto Serif TC	7	23752	25376	0	38036	1645	88809
Noto Serif	8	23924	27712	43600	24968	91621	211825
Nova Cut	12	16336	21532	45324	18839	58433	160464
Nova Flat	12	16224	21364	45672	18605	61853	163718
Nova Mono	11	17808	23404	46528	20255	59328	167323
Nova Oval	12	17252	22664	46712	19630	66025	172283
Nova Round	12	16568	22012	45180	19085	61557	164402
Nova Script	13	20076	26028	56900	23034	81967	208005
Nova Slim	12	16412	21604	45380	18751	61651	163798
Nova Square	13	14644	19556	42560	16755	53108	146623
NTR	8	11984	14388	23472	13195	36302	99341
Numans	10	12292	15540	31344	13287	72072	144535
Nunito Sans	5	16920	20976	38640	19517	49247	145300
Nunito	13	20448	25156	48808	23699	80323	198434
Odibee Sans	2	15004	18884	40488	17446	44748	136570
Offside	8	8836	12184	24576	9637	64136	119369
Old Standard TT	12	22840	27824	62356	25968	79728	218716
Oldenburg	8	14864	18276	26420	15908	105161	180629
Oleo Script Swash Caps	8	14856	18792	33476	16677	83419	167220
Oleo Script	8	12468	16104	28920	13700	75496	146688
Open Sans Condensed	14	14872	18536	28184	15869	54597	132058
Open Sans	17	14380	18100	27088	15404	56266	131238
Oranienbaum	8	20540	24756	53264	23328	72386	194274
Orbitron	16	11444	14836	31996	13158	33600	105034
Oregano	8	29696	33792	57384	32934	209070	362876
Orienta	8	18544	22444	52596	20907	60703	175194
Original Surfer	9	19452	23500	39500	22467	98738	203657
Oswald	35	16016	19740	35848	18329	49576	139509
Over the Rainbow	11	18916	21556	33616	20026	122932	217046
Overlock SC	9	11524	14880	29636	12773	79830	148643
Overlock	9	11312	14760	27384	12463	71162	137081
Overpass Mono	5	18116	22760	44240	20460	50928	156504
Overpass	4	20196	24976	52352	23337	49991	170852
Ovo	12	15912	19564	39456	17247	115517	207696
Oxanium	2	8036	10832	18776	8858	38883	85385
Oxygen Mono	8	16736	21348	39888	18577	51826	148375
Oxygen	9	16344	20468	33720	18365	49176	138073
Pacifico	16	30928	37052	73852	35480	107849	285161
Padauk	6	8340	10364	16592	9152	22409	66857
Palanquin Dark	7	20092	24252	47828	18580	51652	162404
Palanquin	5	20468	24716	48488	18899	53032	165603
Pangolin	6	73888	86588	216608	83588	297281	757953
Paprika	8	13176	16920	32528	14799	81500	158923
Parisienne	7	22596	26536	43112	24782	147217	264243
Passero One	12	12968	16308	26920	14073	70816	141085
Passion One	10	7528	10524	17828	8326	45789	89995
Pathway Gothic One	8	7620	10680	19000	8583	43678	89561
Patrick Hand SC	8	23108	27928	53132	25864	76433	206465
Patrick Hand	13	23744	28764	56620	26647	77299	213074
Pattaya	5	28456	34272	74268	31865	105712	274573
Patua One	10	12888	17064	30964	14887	62749	138552
Pavanam	5	15204	18632	29536	17117	53949	134438
Paytone One	12	19740	24288	51792	23053	53574	172447
Peddana	8	16968	20100	32628	18686	51686	140068
Peralta	8	20184	24468	40760	23577	92249	201238
Permanent Marker	9	29564	36428	70600	35902	284438	456932
Petit Formal Script	8	28100	35920	73968	31636	133243	302867
Petrona	10	21424	25624	46740	24418	80658	198864
Philosopher	12	19520	23952	51312	22644	59494	176922
Piedra	8	26232	30624	67116	29272	176502	329746
Pinyon Script	10	23236	27660	49680	24690	143186	268452
Pirata One	9	8812	12056	26656	9715	67851	125090
Plaster	12	8796	11668	18692	9545	54623	103324
Play	11	17268	21516	41640	19625	51596	151645
Playball	9	14584	18632	35244	16484	87793	172737
Playfair Display SC	9	22520	27048	56832	26267	83965	216632
Playfair Display	21	27352	32132	65376	31812	83422	240094
Podkova	17	18576	22540	44608	21433	54260	161417
Poiret One	8	7856	11016	18804	8863	40467	87006
Poller One	10	10316	13620	25624	11193	72923	133676
Poly	11	11156	14848	28348	12156	65997	132505
Pompiere	10	18844	21656	29976	19706	109380	199562
Pontano Sans	7	22560	28340	70756	25509	54437	201602
Poor Story	8	11428	15548	28316	13842	30261	99395
Poppins	12	7900	10536	16136	8633	52843	96048
Port Lligat Sans	9	10644	14084	26360	11721	69356	132165
Port Lligat Slab	9	11484	14916	30028	12630	78653	147711
Pragati Narrow	5	18748	23108	45132	21321	50620	158929
Prata	11	18476	22608	42212	20983	66052	170331
Press Start 2P	8	12360	15056	41036	14688	31002	114142
Pridi	5	20668	25576	56380	24077	56536	183237
Princess Sofia	9	93908	113380	258296	108230	955400	1529214
Prociono	10	11856	14696	22776	12902	69576	131806
Prompt	4	17664	21844	45436	20059	51410	156413
Prosto One	9	17152	21092	38692	16205	56790	149931
Proza Libre	5	23204	29796	56116	28612	193578	331306
PT Mono	7	27468	32920	55128	30375	57449	203340
PT Sans Caption	12	39328	47320	83628	40345	61600	272221
PT Sans Narrow	11	36268	43724	79568	38000	58580	256140
PT Sans	11	45416	55340	97512	48137	60551	306956
PT Serif Caption	11	39748	47952	84712	40196	65283	277891
PT Serif	11	32960	39452	70032	32922	73858	249224
Public Sans	4	12916	16236	25968	14743	52838	122701
Puritan	12	15828	20208	35500	17665	50977	140178
Purple Purse	9	21092	25496	43580	24610	99841	214619
Quando	9	25696	31108	62656	28247	119249	266956
Quantico	9	5396	8176	14588	5959	30116	64235
Quattrocento Sans	12	24360	29844	79932	27978	61828	223942
Quattrocento	11	35852	43596	129720	40924	124220	374312
Questrial	10	19076	23532	44504	22730	49573	159415
Quicksand	21	13788	17096	29856	15575	82396	158711
Quintessential	8	26200	30668	51632	29894	142998	281392
Qwigley	10	14788	18416	32896	16431	89774	172305
Racing Sans One	7	21892	26988	61748	25099	63794	199521
Radley	15	25976	30928	49164	29218	109001	244287
Rajdhani	9	14980	18572	37904	16434	62679	150569
Rakkas	7	18172	21932	40444	20573	56472	157593
Raleway Dots	8	38752	59968	257920	50295	562120	969055
Raleway	17	20400	24900	44744	23737	52121	165902
Ramabhadra	9	10040	12432	19952	11232	24437	78093
Ramaraja	5	15316	18248	30768	16931	51179	132442
Rambla	7	10980	14636	30576	12802	46966	115960
Rammetto One	9	10776	14084	20784	12110	59909	117663
Ranchers	8	24268	30064	65300	28609	68658	216899
Rancho	10	20540	24204	41536	23216	153969	263465
Ranga	6	15716	19468	29476	17457	84746	166863
Rasa	6	27948	33808	69596	31955	82901	246208
Rationale	12	17396	22636	48788	15712	61233	165765
Ravi Prakash	7	10568	13376	20860	11790	29952	86546
Recursive	20	23964	29064	55656	27638	121953	258275
Red Hat Display	3	19024	23076	45644	21880	55046	164670
Red Hat Text	3	18840	22908	44604	21634	54383	162369
Red Rose	1	18396	21952	39460	20954	79347	180109
Redressed	11	20660	25028	44456	24299	98690	213133
Reem Kufi	7	13864	17440	37816	15986	62329	147435
Reenie Beanie	10	28480	37540	85048	30298	135097	316463
Revalia	7	22816	28696	57536	26057	89290	224395
Rhodium Libre	5	19096	23272	47760	21844	58418	170390
Ribeye Marrow	10	27788	33104	53876	31289	151887	297944
Ribeye	9	27176	31524	56012	30916	163688	309316
Righteous	8	12608	16404	30300	14682	123596	197590
Risque	8	18940	22992	39816	21918	84935	188601
Roboto Condensed	18	15720	20156	36144	17834	48004	137858
Roboto Mono	12	12312	15160	22224	13517	71187	134400
Roboto Slab	12	18608	22932	38696	21298	56982	158516
Roboto	20	15736	20268	36176	17854	48974	139008
Rochester	11	19684	22224	33420	21197	141953	238478
Rock Salt	10	58620	68096	115128	61627	398182	701653
Rokkitt	19	16096	19820	36064	18463	53484	143927
Romanesco	9	17588	20812	36036	19485	124765	218686
Ropa Sans	9	16952	20664	39888	19367	52634	149505
Rosario	18	19812	24416	48232	23253	56793	172506
Rosarivo	8	14756	18532	34684	16298	85699	169969
Rouge Script	9	16440	20304	42688	17887	120871	218190
Rowdies	1	16560	20088	35468	18956	53743	144815
Rozha One	7	18172	22732	43576	20347	55557	160384
Rubik Mono One	8	12828	16480	43820	14179	66898	154205
Rubik	9	22656	27516	56512	26215	84351	217250
Ruda	13	11704	14816	24384	13341	56025	120270
Rufina	7	12844	16728	36388	14868	57220	138048
Ruge Boogie	11	26100	29976	54544	27735	153177	291532
Ruluko	8	8632	11888	20756	9392	54945	105613
Rum Raisin	8	20864	24624	42456	23804	121264	233012
Ruslan Display	11	8372	11004	23348	9179	59361	111264
Russo One	8	7368	10224	18412	8385	44842	89231
Ruthie	11	19472	23436	43836	21047	122926	230717
Rye	8	41440	54860	151100	45713	203067	496180
Sacramento	7	23748	27520	46352	25892	172435	295947
Sahitya	5	22636	26904	49980	25769	91151	216440
Sail	11	13680	17472	29732	15235	82616	158735
Saira Condensed	5	17052	20948	37868	19393	52633	147894
Saira Extra Condensed	5	16588	20480	37804	18972	51948	145792
Saira Semi Condensed	5	17268	21176	38216	19575	53046	149281
Saira Stencil One	2	19484	23832	44468	22089	62173	172046
Saira	4	17124	21080	38032	19394	53404	149034
Salsa	10	13556	17184	32912	15133	73389	152174
Sanchez	7	12792	16260	33984	14372	70647	148055
Sancreek	11	20328	24048	35488	21942	142740	244546
Sansita	5	20900	25820	55704	23718	62334	188476
Sarabun	7	10412	13540	23720	11906	54143	113721
Sarala	4	17796	22384	43044	20246	52080	155550
Sarina	9	20044	24172	44628	21565	130579	240988
Sarpanch	6	13656	17908	34944	15472	43301	125281
Satisfy	10	22652	26352	44256	25224	165449	283933
Sawarabi Gothic	8	9176	12260	21172	10027	53036	105671
Sawarabi Mincho	10	10196	12980	19716	11028	61260	115180
Scada	8	15016	18728	37148	17219	57103	145214
Scheherazade	17	22484	29628	59544	26983	94514	233153
Schoolbell	11	21408	25580	45280	24590	167718	284576
Scope One	7	21216	26064	53692	24121	75393	200486
Seaweed Script	7	43640	50820	108776	48366	385407	637009
Secular One	5	11360	14524	26556	13089	55670	121199
Sedgwick Ave Display	6	34208	39560	73936	38140	117877	303721
Sedgwick Ave	6	34912	40640	73688	39152	116680	305072
Sen	2	16236	19780	37644	18198	54638	146496
Sevillana	9	52840	66980	146128	60184	141422	467554
Seymour One	8	20488	25240	43220	22791	66361	178100
Shadows Into Light Two	7	15856	19108	27772	16784	93228	172748
Shadows Into Light	9	16288	18700	29192	17301	108597	190078
Shanti	12	24380	36020	75516	35862	291565	463343
Share Tech Mono	9	13596	17300	35720	15280	46581	128477
Share Tech	10	15144	19408	41568	17565	46099	139784
Share	10	26168	31960	67200	26689	54686	206703
Shojumaru	8	24712	29108	49604	28469	132561	264454
Short Stack	10	24412	28132	53312	26459	166890	299205
Shrikhand	5	16024	19544	37936	18141	115564	207209
Sigmar One	10	43348	49528	90860	47939	202459	434134
Signika Negative	10	12116	15856	27000	13611	64314	132897
Signika	11	29860	34928	65388	34714	94552	259442
Simonetta	11	43164	54140	109600	46845	114399	368148
Sintony	7	8548	11836	20652	9440	48999	99475
Sirin Stencil	9	29104	35712	63864	29445	129327	287452
Six Caps	10	14384	18072	31000	16347	52717	132520
Skranji	8	67804	80404	185680	78260	681713	1093861
Slabo 13px	8	14792	18736	39124	15763	50049	138464
Slabo 27px	6	15876	20336	40632	18044	51903	146791
Slackey	11	18556	21704	34496	20923	132432	228111
Smokum	11	16168	19924	31668	18689	126520	212969
Smythe	11	30452	36348	67468	34987	110718	279973
Sniglet	12	24736	29268	65300	27921	107208	254433
Snippet	10	12340	16776	36224	15564	138676	219580
Snowburst One	8	32284	37416	52956	35055	160990	318701
Sofadi One	9	19472	23848	45988	20159	95954	205421
Sofia	9	11512	14916	25564	12551	81782	146325
Solway	3	20884	25164	51728	23694	89823	211293
Song Myung	8	13912	18752	39796	16947	46929	136336
Sonsie One	9	16864	21320	37140	17622	114994	207940
Sora	1	12392	15596	26884	14348	53862	123082
Sorts Mill Goudy	9	21704	25792	53108	24879	104931	230414
Source Code Pro	11	14172	18008	33148	16407	57641	139376
Source Sans Pro	13	16112	20180	40408	19035	60072	155807
Source Serif Pro	8	19368	23652	48312	23063	70613	185008
Space Mono	5	15748	19280	37128	17754	55627	145537
Spartan	2	11316	14736	23072	12699	57351	119174
Special Elite	10	53368	63724	116896	59319	437745	731052
Spectral SC	5	18728	22692	48260	21927	58016	169623
Spectral	6	21144	25372	55108	24416	62413	188453
Spicy Rice	9	22616	26520	47012	26168	135537	257853
Spinnaker	11	10504	13628	20508	11461	62199	118300
Spirax	9	15972	20060	44980	18502	78917	178431
Squada One	8	5644	8436	17136	6226	44310	81752
Sree Krushnadevaraya	8	13032	15252	24500	13856	32878	99518
Sriracha	4	39152	48412	104528	44817	98332	335241
Srisakdi	4	15044	18444	32048	16821	101136	183493
Staatliches	3	15764	19112	38184	18368	65083	156511
Stalemate	8	25944	29652	54276	28827	160732	299431
Stalinist One	26	11360	15108	29996	12989	31421	100874
Stardos Stencil	11	14840	18784	34536	16363	95182	179705
Stint Ultra Condensed	9	12044	14856	25700	13474	67341	133415
Stint Ultra Expanded	8	12928	16064	27836	14343	73523	144694
Stoke	10	28788	34320	72136	31192	128932	295368
Strait	8	9036	12244	24228	9923	57973	113404
Stylish	8	15148	18944	32932	17790	50554	135368
Sue Ellen Francisco	11	14528	18128	31964	15145	71187	150952
Suez One	4	14408	17784	30828	16576	64228	143824
Sulphur Point	2	15720	19272	35368	17916	54323	142599
Sumana	5	23984	28880	61500	27123	76226	217713
Sunflower	9	9020	12668	25564	11114	21943	80309
Sunshiney	11	61052	72720	152948	69289	552624	908633
Supermercado One	10	21308	27152	68776	23701	103813	244750
Sura	5	18324	21948	37120	20467	66771	164630
Suranna	7	12548	14836	23444	13334	31557	95719
Suravaram	7	16036	19196	31532	17608	43836	128208
Swanky and Moo Moo	10	18368	21048	33968	20075	135240	228699
Syncopate	11	32268	41572	105880	37449	66922	284091
Tajawal	3	10228	13508	24988	11578	50554	110856
Tangerine	11	23236	28140	54620	22989	108345	237330
Tauri	9	15064	18416	28652	16694	68518	147344
Taviraj	5	22172	27400	57708	25266	69416	201962
Teko	9	13324	17256	34796	15041	43161	123578
Telex	8	14324	17808	30528	16264	48374	127298
Tenali Ramakrishna	7	10480	12788	21448	11701	29047	85464
Tenor Sans	11	18500	22980	52024	17831	63143	174478
Text Me One	8	10764	14228	31216	11460	80560	148228
Thasadith	4	10672	13808	24244	12154	63819	124697
The Girl Next Door	11	22616	26516	39312	23951	121682	234077
Tienne	13	25924	30904	57016	28491	117796	260131
Tillana	6	18080	22660	40196	20112	62550	163598
Timmana	5	10724	12908	20640	11764	26966	83002
Tinos	13	28000	34028	61408	26779	58718	208933
Titan One	8	10760	13768	25740	11694	69179	131141
Titillium Web	8	12356	16572	30036	14710	43156	116830
Tomorrow	3	7604	10496	20864	8648	34794	82406
Trade Winds	9	36444	42456	81212	40374	295523	496009
Trirong	5	20380	25280	50720	23024	63937	183341
Trocchi	9	21728	26216	44928	24397	83762	201031
Trochut	8	7780	10652	20980	8594	49806	97812
Trykker	9	12404	15608	22560	13387	81834	145793
Tulpen One	10	11624	15836	31132	15080	149991	223663
Turret Road	2	13304	17108	30016	15121	36116	111665
Ubuntu Condensed	10	28608	33052	62684	27446	60595	212385
Ubuntu Mono	9	27264	32176	55060	27671	58727	200898
Ubuntu	14	34260	39164	77256	31600	63335	245615
Ultra	12	13616	16736	28048	15463	111843	185706
Uncial Antiqua	8	19920	24004	43684	23261	105957	216826
Underdog	9	16768	20872	36648	19096	50594	143978
Unica One	7	6100	8848	17816	6725	42613	82102
UnifrakturCook	12	17208	20760	29988	18376	80684	167016
UnifrakturMaguntia	11	26252	31656	57396	28402	123335	267041
Unkempt	12	70692	84668	184252	80652	675423	1095687
Unlock	10	8268	11472	21216	9062	49976	99994
Unna	13	20476	24704	45156	23258	75778	189372
Vampiro One	11	13456	16572	24120	14752	62176	131076
Varela Round	12	20416	25220	51296	23464	82986	203382
Varela	10	19048	25272	50700	21799	43076	159895
Varta	1	11348	14504	23260	12799	55101	117012
Vast Shadow	10	22888	27812	52604	24628	140314	268246
Vesper Libre	12	13840	17412	26456	15420	77707	150835
Viaoda Libre	3	26932	32248	63144	30243	89318	241885
Vibes	2	17564	21192	34104	19472	75284	167616
Vibur	11	41744	50876	84420	48012	117712	342764
Vidaloka	12	30028	36788	78752	30009	80878	256455
Viga	8	8260	11460	19680	9000	50266	98666
Voces	10	17108	21496	42052	19313	57990	157959
Volkhov	11	27496	34104	70888	28034	55223	215745
Vollkorn SC	4	21716	25936	48864	24776	81828	203120
Vollkorn	12	21412	25320	49008	24209	98996	218945
Voltaire	10	9200	12272	23304	9920	65571	120267
VT323	11	17684	21656	75048	20511	142105	277004
Waiting for the Sunrise	11	18060	21408	34244	18965	115845	208522
Wallpoet	12	12500	16712	34432	15140	65828	144612
Walter Turncoat	11	60232	70164	147740	68765	565113	912014
Warnes	10	22072	27680	83932	24717	82802	241203
Wellfleet	8	15560	19720	38008	16919	106156	196363
Wendy One	9	7956	10980	19164	8677	49959	96736
Wire One	11	34212	42784	94360	34729	111189	317274
Work Sans	8	24212	29400	57280	28718	55244	194854
Yanone Kaffeesatz	15	19900	23748	42576	22771	79038	188033
Yantramanav	5	16680	21260	40360	18942	44621	141863
Yatra One	7	15672	19752	37740	17454	61227	151845
Yellowtail	10	18304	22388	34964	19915	117637	213208
Yeon Sung	8	21668	27668	48920	25457	74350	198063
Yeseva One	14	16652	20528	40408	18869	66250	162707
Yesteryear	8	23060	26972	45088	25468	150121	270709
Yrsa	5	26656	32192	64964	30333	82901	237046
ZCOOL KuaiLe	5	8496	10960	17180	9620	20172	66428
ZCOOL QingKe HuangYou	5	11492	14232	26760	12992	43455	108931
ZCOOL XiaoWei	5	14156	17332	36216	16182	30208	114094
Zeyada	10	19948	22852	37260	21810	146836	248706
Zhi Mang Xing	5	13076	15148	23104	14419	53090	118837
Zilla Slab Highlight	8	23472	27952	62724	26635	56449	197232
Zilla Slab	5	23776	29404	67320	27892	51314	199706
